050 050 050 050 050 050 050 050 050 050 050 050 050 050 050 050 050 050 050 050 050 050 050 050 050 050 050 050 050 050 050 050 013 056 057 084 062 062 062 062 062 062 062 062 062 062 062 062 062 079 057 020 050 050 050 050 050 050 050 050 050 050 050 050 050 050 050 050 050 050 050 050 050 050 050 050 050 050 050 050 050 050 050 050 050 050 050 050 050 050
050 050 050 050 050 050 050 050 050 050 050 050 050 050 050 050 050 050 050 050 050 050 050 050 050 050 050 050 050 050 050 050 013 056 057 084 062 062 062 062 062 062 062 062 062 062 062 062 062 079 057 020 050 050 050 050 050 050 050 050 050 050 050 050 050 050 050 050 050 050 050 050 050 050 050 050 050 050 050 050 050 050 050 050 050 050 050 050 050 050
050 050 050 050 050 050 050 050 050 050 050 050 050 050 050 050 050 050 050 050 050 050 050 050 050 050 050 050 050 050 050 050 013 056 057 084 062 062 062 062 062 062 062 062 101 062 062 062 062 079 057 020 050 050 050 050 050 050 050 050 050 050 050 050 050 050 050 050 050 050 050 050 050 050 050 050 050 050 050 050 050 050 050 050 050 050 050 050 050 050
050 050 050 050 050 050 050 050 050 050 050 050 050 050 050 050 050 050 050 050 050 050 050 050 050 050 050 050 050 050 050 050 013 056 057 084 062 062 062 062 062 062 062 062 062 062 062 062 062 079 057 020 050 050 050 050 050 050 050 050 050 050 050 050 050 050 050 050 050 050 050 050 050 050 050 050 050 050 050 050 050 050 050 050 050 050 050 050 050 050
050 050 050 050 050 050 050 050 050 050 050 050 050 050 050 050 050 050 050 050 050 050 050 050 050 050 050 050 050 050 050 050 013 056 057 084 062 062 062 062 062 062 062 062 062 062 062 062 062 079 057 020 050 050 050 050 050 050 050 050 050 050 050 050 050 050 050 050 050 050 050 050 050 050 050 050 050 050 050 050 050 050 050 050 050 050 050 050 050 050
050 050 050 050 050 050 050 050 050 050 050 050 050 050 050 050 050 050 050 050 050 050 050 050 050 050 050 050 050 050 050 050 013 056 057 084 062 062 062 062 062 062 062 062 062 062 062 062 062 079 057 020 050 050 050 050 050 050 050 050 050 050 050 050 050 050 050 050 050 050 050 050 050 050 050 050 050 050 050 050 050 050 050 050 050 050 050 050 050 050
050 050 050 050 050 050 050 050 050 050 050 050 050 050 050 050 050 050 050 050 050 050 050 050 050 050 050 050 050 050 050 050 013 056 057 084 062 062 062 062 062 062 062 062 062 062 062 062 062 079 050 020 050 050 050 050 050 050 050 050 050 050 050 050 050 050 050 050 050 050 050 050 050 050 050 050 050 050 050 050 050 050 050 050 050 050 050 050 050 050
050 050 050 050 050 050 050 050 050 050 050 050 050 050 050 050 050 050 050 050 050 050 050 050 050 050 050 050 050 050 050 050 013 056 057 084 062 062 062 062 062 062 062 062 062 062 062 101 062 079 050 020 050 050 050 050 050 050 050 050 050 050 050 050 050 050 050 050 050 050 050 050 050 050 050 050 050 050 050 050 050 050 050 050 050 050 050 050 050 050
050 050 050 050 050 050 050 050 050 050 050 050 050 050 050 050 050 050 050 050 050 050 050 050 050 050 050 050 050 050 050 050 013 056 057 084 062 062 062 062 102 062 062 062 062 062 062 062 062 079 050 020 050 050 050 050 050 050 050 050 050 050 050 050 050 050 050 050 050 050 050 050 050 050 050 050 050 050 050 050 050 050 050 050 050 050 050 050 050 050
050 050 050 050 050 050 050 050 050 050 050 050 050 050 050 050 050 050 050 050 050 050 050 050 050 050 050 050 050 050 050 050 013 056 057 084 062 062 062 062 062 062 062 062 062 062 062 062 062 079 050 020 050 050 050 050 050 050 050 050 050 050 050 050 050 050 050 050 050 050 050 050 050 050 050 050 050 050 050 050 050 050 050 050 050 050 050 050 050 050
050 050 050 050 050 050 050 050 050 050 050 050 050 050 050 050 050 050 050 050 050 050 050 050 050 050 050 050 050 050 050 050 013 056 057 084 062 062 062 062 062 062 062 062 102 062 062 062 062 079 050 020 050 050 050 050 050 050 050 050 050 050 050 050 050 050 050 050 050 050 050 050 050 050 050 050 050 050 050 050 050 050 050 050 050 050 050 050 050 050
050 050 050 050 050 050 050 050 050 050 050 050 050 050 050 050 050 050 050 050 050 050 050 050 050 050 050 050 050 050 050 050 013 056 057 084 062 062 062 062 062 062 062 062 062 062 062 062 062 079 050 020 050 050 050 050 050 050 050 050 050 050 050 050 050 050 050 050 050 050 050 050 050 050 050 050 050 050 050 050 050 050 050 050 050 050 050 050 050 050
050 050 050 050 050 050 050 050 050 050 050 050 050 050 050 050 050 050 050 050 050 050 050 050 050 050 050 050 050 050 050 050 013 056 057 094 091 091 091 091 091 091 091 091 091 091 091 091 091 095 050 020 050 050 050 050 050 050 050 050 050 050 050 050 050 050 050 050 050 050 050 050 050 050 050 050 050 050 050 050 050 050 050 050 050 050 050 050 050 050
050 050 050 050 050 050 050 050 010 024 024 024 024 024 024 024 024 024 024 024 024 024 024 024 024 024 024 024 024 024 024 024 014 056 057 050 050 050 051 051 051 051 051 051 051 051 051 051 050 050 050 020 050 050 050 050 050 050 050 050 050 050 050 050 050 050 050 050 050 050 050 050 050 050 050 050 050 050 050 050 050 050 050 050 050 050 050 050 050 050
050 050 050 050 050 050 050 050 011 025 025 025 025 025 025 025 025 025 025 025 025 025 025 025 025 025 025 025 025 025 025 025 015 056 057 050 050 050 051 113 113 113 113 113 113 113 113 051 050 050 050 020 050 050 050 050 050 050 050 050 050 050 050 050 050 050 050 050 050 050 050 050 050 050 050 050 050 050 050 050 050 050 050 050 050 050 050 050 050 050
050 050 050 050 050 050 050 050 012 027 026 027 026 027 026 027 026 027 026 027 026 027 026 027 026 027 026 027 026 027 026 027 016 050 050 050 050 050 051 142 143 113 155 156 113 142 143 051 050 050 050 020 050 050 050 050 050 050 050 050 050 050 050 050 050 050 050 050 050 050 050 050 050 050 050 050 050 050 050 050 050 050 050 050 050 050 050 050 050 050
050 050 050 050 050 050 050 050 013 057 057 057 057 057 057 057 057 057 057 057 057 114 109 109 109 109 109 109 109 109 115 050 050 050 050 050 050 050 051 159 160 035 157 158 035 159 160 051 050 050 050 020 050 050 050 050 050 050 050 050 050 050 050 050 050 050 050 050 050 050 050 050 050 050 050 050 050 050 050 050 050 050 050 050 050 050 050 050 050 050
050 050 050 050 050 050 050 050 013 057 050 050 050 050 050 050 050 050 050 050 050 111 113 113 113 113 113 113 113 113 112 050 050 050 050 050 050 050 051 035 035 035 035 035 035 035 035 051 050 050 050 020 050 050 050 050 050 050 050 050 050 050 050 050 050 050 050 050 050 050 050 050 050 050 050 050 050 050 050 050 050 050 050 050 050 050 050 050 050 050
050 050 050 050 050 050 050 050 013 057 050 057 057 057 008 029 029 029 029 030 050 111 153 154 142 143 113 113 113 113 112 050 050 050 050 050 050 050 051 035 035 035 035 035 035 035 035 051 050 050 050 020 050 050 050 050 050 050 050 050 050 050 050 050 050 050 050 050 050 050 050 050 050 050 050 050 050 050 050 050 050 050 050 050 050 050 050 050 050 050
050 050 050 050 050 050 050 050 013 057 050 050 050 057 020 050 050 050 050 013 050 120 146 148 144 145 001 001 001 001 121 050 050 050 050 050 050 056 051 035 035 035 035 035 035 035 035 051 057 050 050 020 050 050 050 050 050 050 050 050 050 050 050 050 050 050 050 050 050 050 050 050 050 050 050 050 050 050 050 050 050 050 050 050 050 050 050 050 050 050
050 050 050 050 050 050 050 050 013 057 057 057 057 057 020 050 050 050 050 013 050 120 001 001 001 001 001 001 001 001 121 050 050 050 050 050 051 051 051 035 035 035 035 035 035 035 035 051 051 051 050 020 050 050 050 050 050 050 050 050 050 050 050 050 050 050 050 050 050 050 050 050 050 050 050 050 050 050 050 050 050 050 050 050 050 050 050 050 050 050
050 050 050 050 050 050 050 050 028 029 029 029 029 029 009 050 050 050 050 013 050 120 001 001 001 001 001 001 001 001 121 040 040 073 050 050 031 001 051 035 035 035 035 035 035 035 035 051 001 031 050 020 050 050 050 050 050 050 050 050 050 050 050 050 050 050 050 050 050 050 050 050 050 050 050 050 050 050 050 050 050 050 050 050 050 050 050 050 050 050
050 050 050 050 050 050 050 050 050 050 050 050 050 050 050 050 050 050 050 013 050 120 146 151 001 001 001 001 001 001 005 042 042 044 050 050 032 001 051 035 035 035 035 035 035 035 035 051 001 031 050 020 050 050 050 050 050 050 050 050 050 050 050 050 050 050 050 050 050 050 050 050 050 050 050 050 050 050 050 050 050 050 050 050 050 050 050 050 050 050
050 050 050 050 050 050 050 050 050 050 050 050 050 050 050 050 050 050 050 013 050 125 119 119 119 119 119 119 119 119 124 045 042 044 050 050 032 001 051 035 035 035 035 035 035 035 035 051 001 031 050 020 050 050 050 050 050 050 050 050 050 050 050 050 050 050 050 050 050 050 050 050 050 050 050 050 050 050 050 050 050 050 050 050 050 050 050 050 050 050
050 050 050 050 050 050 050 050 050 050 050 050 050 050 050 050 050 050 050 013 050 050 050 050 050 050 050 050 050 050 050 043 042 044 050 050 032 001 001 035 035 035 035 035 035 035 035 001 001 031 050 020 050 050 050 050 050 050 050 050 050 050 050 050 050 050 050 050 050 050 050 050 050 050 050 050 050 050 050 050 050 050 050 050 050 050 050 050 050 050
050 050 050 050 050 050 050 050 050 050 050 050 050 050 050 050 050 050 050 028 029 029 029 029 029 029 030 050 050 050 050 043 042 044 050 050 051 051 051 051 051 051 003 003 051 051 051 051 051 051 050 020 050 050 050 050 050 050 050 050 050 050 050 050 050 050 050 050 050 050 050 050 050 050 050 050 050 050 050 050 050 050 050 050 050 050 050 050 050 050
050 050 050 050 050 050 050 050 050 050 050 050 050 050 050 050 050 050 050 050 050 050 050 050 050 050 013 057 071 040 040 046 042 048 040 040 040 040 040 040 040 046 042 042 048 040 040 040 040 073 050 020 050 050 050 050 050 050 050 050 050 050 050 050 050 050 050 050 050 050 050 050 050 050 050 050 050 050 050 050 050 050 050 050 050 050 050 050 050 050
050 050 050 050 050 050 050 050 050 050 050 050 050 050 050 050 050 050 050 050 050 050 050 050 050 050 013 057 043 042 042 042 042 042 042 042 042 042 042 042 042 042 042 042 042 042 042 042 042 044 050 020 050 050 050 050 050 050 050 050 050 050 050 050 050 050 050 050 050 050 050 050 050 050 050 050 050 050 050 050 050 050 050 050 050 050 050 050 050 050
050 050 050 050 050 050 050 050 050 050 050 050 050 050 050 050 050 050 050 050 050 050 050 050 050 050 013 057 043 042 047 041 041 041 041 041 041 041 041 041 041 041 041 041 041 041 041 045 042 044 050 020 050 050 050 050 050 050 050 050 050 050 050 050 050 050 050 050 050 050 050 050 050 050 050 050 050 050 050 050 050 050 050 050 050 050 050 050 050 050
050 050 050 050 050 050 050 050 050 050 050 050 050 050 050 050 050 050 050 050 050 050 050 050 050 050 013 057 043 042 044 010 024 024 024 024 024 024 024 024 024 024 024 024 024 017 050 043 042 044 056 020 050 050 050 050 050 050 050 050 050 050 050 050 050 050 050 050 050 050 050 050 050 050 050 050 050 050 050 050 050 050 050 050 050 050 050 050 050 050
050 050 050 050 050 050 050 050 050 050 050 050 050 050 050 050 050 050 050 050 050 050 050 050 050 050 013 057 043 042 044 011 025 025 025 025 025 025 025 025 025 025 025 025 025 018 076 043 042 044 056 020 050 050 050 050 050 050 050 050 050 050 050 050 050 050 050 050 050 050 050 050 050 050 050 050 050 013 056 084 062 062 062 062 062 062 062 050 050 050
050 050 050 050 050 050 050 050 050 050 050 050 050 050 050 050 050 050 050 050 050 050 050 050 050 050 013 057 043 042 044 083 089 088 089 088 089 088 089 088 089 088 089 088 089 078 077 043 042 044 056 020 050 050 050 050 050 050 050 050 050 050 050 050 050 050 050 050 050 050 050 050 050 050 050 050 050 013 056 084 062 062 062 062 062 062 062 050 050 050
050 050 050 050 050 050 050 050 050 050 050 050 050 050 050 050 050 050 050 050 050 050 050 050 050 050 013 057 043 042 044 084 062 062 062 062 062 062 062 062 062 062 062 062 102 079 057 043 042 044 056 020 050 050 050 050 050 050 050 050 050 050 050 050 050 050 050 050 050 050 050 050 050 050 050 050 050 013 056 084 062 062 062 062 062 062 062 050 050 050
050 050 050 050 050 050 050 050 050 050 050 050 050 050 050 050 050 050 050 050 050 050 050 050 050 050 013 057 043 042 053 084 062 062 062 062 062 062 062 062 062 062 062 062 062 079 057 135 136 137 056 021 024 024 024 024 024 024 024 024 024 024 017 050 050 050 050 050 050 050 050 050 050 050 050 050 050 013 056 084 062 062 062 062 062 062 062 050 050 050
050 050 050 050 050 050 050 050 050 050 050 050 050 050 050 050 050 050 050 050 050 050 050 050 050 050 013 057 135 136 137 084 062 062 101 062 062 062 062 062 062 062 062 062 062 079 057 043 042 054 056 022 025 025 025 025 025 025 025 025 025 025 018 050 050 050 050 050 050 050 050 050 050 050 050 050 050 013 056 084 062 062 062 062 062 062 062 050 050 050
050 050 050 050 050 050 050 050 050 050 050 050 050 050 050 050 050 050 050 050 050 050 050 050 050 050 013 057 043 042 044 084 062 062 062 062 062 062 062 062 062 062 062 062 062 079 057 043 042 044 056 023 026 027 026 027 026 027 026 027 026 027 019 050 050 050 050 050 050 050 050 050 050 050 050 050 050 013 056 084 062 062 062 062 062 062 062 050 050 050
050 050 050 050 050 050 050 050 050 050 050 050 050 050 050 050 050 050 050 050 050 050 050 050 050 050 013 057 043 042 044 084 062 062 062 062 062 062 062 062 102 062 062 062 062 079 057 043 042 044 050 050 050 050 050 050 050 050 050 056 056 056 020 050 050 050 050 050 050 050 050 050 050 050 050 050 050 013 056 084 062 062 062 062 101 062 062 050 050 050
050 050 050 050 050 050 050 050 050 050 050 050 010 024 024 024 024 024 024 024 024 024 024 024 024 024 014 057 043 042 044 084 062 062 062 062 062 062 062 062 062 062 062 062 062 079 057 043 042 044 050 050 050 114 109 109 109 109 109 109 109 115 021 024 024 024 024 024 024 024 024 024 024 024 024 024 024 014 056 084 062 062 062 062 062 062 062 050 050 050
050 050 050 050 050 050 050 050 050 050 050 050 011 025 025 025 025 025 025 025 025 025 025 025 025 025 015 057 043 042 044 084 062 062 062 062 062 062 062 062 062 062 062 062 062 079 050 043 042 044 050 050 050 111 113 113 113 113 113 113 113 112 022 025 025 025 025 025 025 025 025 025 025 025 025 025 025 015 056 084 062 062 062 062 062 062 062 050 050 050
050 050 050 050 050 050 050 050 050 050 050 050 012 027 026 027 026 027 026 027 026 027 026 027 026 027 016 050 043 042 044 084 062 062 062 062 062 062 062 062 062 062 062 062 062 079 050 043 042 044 050 050 050 111 153 154 142 143 113 113 113 112 023 026 027 026 027 026 027 026 027 026 027 026 027 026 027 016 056 084 062 062 062 062 062 062 062 050 050 050
050 050 050 050 050 050 050 050 050 050 050 050 013 056 050 050 050 050 050 050 050 050 050 050 050 050 050 050 043 042 044 084 062 062 062 102 062 062 062 062 062 062 062 062 062 079 050 043 042 044 050 050 050 120 146 149 144 145 001 001 001 001 050 050 050 050 050 050 050 050 050 050 050 050 050 050 050 050 050 084 062 102 062 062 062 062 062 050 050 050
050 050 050 050 050 050 050 050 050 050 050 050 013 050 050 050 114 109 109 109 109 109 109 109 115 050 050 050 043 042 044 084 062 062 062 062 062 062 062 062 062 062 062 062 062 079 050 043 042 044 050 050 050 120 001 001 001 001 001 001 001 121 010 024 024 024 024 024 024 024 017 050 050 050 050 050 050 050 050 084 062 062 062 062 062 062 062 050 050 050
050 050 050 050 050 050 050 050 050 050 050 050 013 050 050 050 111 113 113 113 113 113 113 113 112 050 050 050 043 042 044 084 062 062 062 062 062 062 062 062 062 062 062 062 062 079 050 043 042 044 050 050 050 120 001 001 001 001 001 001 001 121 011 025 025 025 025 025 025 025 018 076 050 076 050 076 050 050 076 084 062 062 062 062 062 062 062 050 050 050
050 050 050 050 050 050 050 050 050 050 050 050 013 050 050 050 111 153 154 142 143 113 113 113 112 050 050 050 043 042 044 084 062 062 062 062 062 062 062 062 062 062 062 101 062 079 050 043 042 044 056 050 050 120 146 152 001 001 001 001 001 121 083 089 088 089 088 089 088 089 078 077 050 077 050 077 050 050 077 084 062 062 062 062 062 062 062 050 050 050
050 050 050 050 050 050 050 050 050 050 050 050 013 050 050 050 120 146 147 144 145 001 001 001 121 050 050 050 043 042 044 084 062 062 062 062 062 062 062 062 062 062 062 062 062 079 050 043 042 044 057 050 050 125 119 119 119 119 003 119 119 124 084 062 062 062 062 062 062 102 079 076 050 076 050 076 050 050 076 084 062 062 062 062 062 062 062 050 050 050
050 050 050 050 050 050 050 050 050 050 050 050 013 050 050 050 120 001 001 001 001 001 001 001 121 050 050 050 043 042 044 084 062 062 062 062 062 062 062 062 062 062 062 062 062 079 050 043 042 048 040 040 040 040 040 040 040 046 042 044 050 050 084 101 062 062 062 062 062 062 079 077 050 077 050 077 050 050 077 084 101 062 062 062 062 062 062 050 050 050
050 050 050 050 050 024 024 024 024 024 024 024 014 050 050 050 120 001 001 001 001 001 001 001 121 050 050 050 043 042 044 084 101 062 062 062 062 062 062 062 062 062 062 062 062 079 050 043 042 042 042 042 042 042 042 042 042 042 042 044 050 050 084 062 062 062 062 062 062 062 079 076 050 076 050 076 050 050 076 084 062 062 062 062 062 062 062 050 050 050
050 050 050 050 050 025 025 025 025 025 025 025 015 050 050 050 120 146 150 001 001 001 001 001 121 050 050 050 043 042 044 084 062 062 062 062 062 062 062 101 062 062 062 062 062 079 050 072 041 041 041 041 041 041 041 041 041 041 041 074 050 050 084 062 062 062 062 062 062 062 079 077 050 077 050 077 050 050 077 084 062 062 062 062 062 062 062 050 050 050
050 050 050 050 050 027 026 027 026 027 026 027 016 050 050 050 125 119 119 119 119 119 119 003 124 052 050 050 043 042 044 084 062 062 062 062 062 062 062 062 062 062 062 062 062 079 050 050 050 050 050 050 050 131 126 126 126 126 132 050 050 050 084 062 062 062 062 062 062 062 080 024 024 024 024 024 024 024 024 085 062 062 062 062 062 062 062 050 050 050
050 050 050 050 050 040 040 040 040 040 040 040 067 040 040 040 040 040 040 040 040 040 046 042 048 040 040 040 046 042 044 084 062 062 062 062 062 062 062 062 062 062 062 062 062 079 050 050 050 141 050 050 050 129 127 127 127 127 130 050 050 050 084 062 062 062 062 062 062 062 081 025 025 025 025 025 025 025 025 086 062 062 062 062 062 062 062 050 050 050
050 050 050 050 050 042 042 042 042 042 042 042 068 042 042 042 042 042 042 042 042 042 042 042 042 042 042 042 042 042 044 084 062 062 062 062 062 062 062 062 062 062 062 062 062 079 050 050 050 050 050 050 050 129 127 127 127 127 130 050 050 050 084 062 062 062 102 062 062 062 082 088 089 088 089 088 089 088 089 087 062 062 062 062 062 062 062 050 050 050
050 050 050 050 050 041 041 041 041 041 041 041 069 041 041 041 041 041 041 041 041 041 041 041 041 041 041 041 041 041 074 084 062 062 062 062 062 062 062 062 062 062 062 062 062 079 050 050 050 141 050 050 050 129 127 127 127 127 130 050 050 076 084 062 062 062 062 062 062 062 062 101 062 062 062 062 062 062 062 062 062 062 062 102 101 062 062 050 050 050
050 050 050 050 050 029 029 029 029 029 029 029 030 050 050 050 050 050 050 050 050 050 050 050 050 050 050 050 050 050 050 084 062 062 062 062 062 062 062 062 062 062 062 062 062 079 076 050 050 050 050 050 050 129 127 127 127 127 130 050 050 077 084 062 062 062 062 062 062 062 062 062 062 062 062 062 062 062 062 062 062 062 062 062 062 062 062 062 050 050
050 050 050 050 050 050 050 050 050 050 050 050 013 050 050 050 050 050 050 050 050 050 050 050 050 050 050 050 050 050 050 084 062 062 102 062 062 062 062 062 062 062 062 062 062 079 077 050 140 139 139 139 138 133 128 128 128 128 134 050 050 050 084 102 062 062 062 062 062 062 062 062 062 062 062 062 062 062 062 062 062 062 062 062 062 062 062 062 050 050
050 050 050 050 050 050 050 050 050 050 050 050 013 050 076 058 059 036 036 060 050 058 036 036 060 050 050 050 050 050 050 084 062 062 062 062 062 062 062 062 062 062 062 062 062 080 024 024 024 024 024 024 024 024 024 024 024 024 024 024 024 024 085 062 062 062 062 062 062 062 062 062 062 062 062 062 062 062 062 062 062 062 050 050 050 050 050 050 050 050
050 050 050 050 050 050 050 050 050 050 050 050 013 050 077 037 103 062 062 038 050 061 105 062 063 050 050 050 050 050 050 084 062 062 062 062 062 062 062 062 062 062 062 062 102 081 025 025 025 025 025 025 025 025 025 025 025 025 025 025 025 025 086 062 062 062 062 062 062 062 050 050 050 050 050 050 050 050 050 050 050 050 050 050 050 050 050 050 050 050
050 050 050 050 050 050 050 050 050 050 050 050 013 050 050 037 062 104 062 038 050 037 062 106 038 050 050 050 050 050 050 084 062 062 062 062 062 062 062 062 062 062 062 062 062 082 088 089 088 089 088 089 088 089 088 089 088 089 088 089 088 089 087 062 062 062 062 062 062 062 050 050 050 050 050 050 050 050 050 050 050 050 050 050 050 050 050 050 050 050
050 050 050 050 050 050 050 050 050 050 050 050 013 050 050 037 062 062 062 038 050 064 065 039 066 050 050 050 050 050 050 084 062 062 062 062 062 062 062 062 062 062 062 062 062 062 062 062 062 062 062 062 062 062 062 101 062 062 062 062 062 062 062 062 062 062 062 062 062 062 050 050 050 050 050 050 050 050 050 050 050 050 050 050 050 050 050 050 050 050
050 050 050 050 050 050 050 050 050 050 050 050 013 050 050 037 062 062 104 038 050 050 050 050 050 050 050 050 050 050 050 084 062 062 062 062 062 062 062 062 062 062 062 062 062 062 062 062 062 062 062 062 062 062 062 062 062 062 062 062 062 062 062 062 101 062 062 062 062 062 050 050 050 050 050 050 050 050 050 050 050 050 050 050 050 050 050 050 050 050
050 050 050 050 050 050 050 050 050 050 050 050 013 050 050 037 103 062 062 038 050 058 036 036 060 050 050 050 050 050 141 084 062 062 062 062 062 062 062 062 062 062 062 062 062 062 062 062 062 062 062 062 062 062 062 062 062 062 062 062 062 062 062 062 062 062 062 062 050 050 050 050 050 050 050 050 050 050 050 050 050 050 050 050 050 050 050 050 050 050
050 050 050 050 050 050 050 050 050 050 050 050 013 050 050 037 062 062 062 038 050 037 108 062 038 050 050 050 140 139 138 084 062 062 062 062 062 062 062 062 050 050 050 050 050 050 050 050 050 050 050 050 050 050 050 050 050 050 050 050 050 050 050 050 050 050 050 050 050 050 050 050 050 050 050 050 050 050 050 050 050 050 050 050 050 050 050 050 050 050
050 050 050 050 050 050 050 050 050 050 050 050 013 050 076 061 062 062 103 038 050 037 062 107 063 076 050 050 050 050 050 084 062 062 062 062 062 062 062 062 050 050 050 050 050 050 050 050 050 050 050 050 050 050 050 050 050 050 050 050 050 050 050 050 050 050 050 050 050 050 050 050 050 050 050 050 050 050 050 050 050 050 050 050 050 050 050 050 050 050
050 050 050 050 050 050 050 050 050 050 050 050 013 050 077 064 039 039 039 066 050 064 039 065 066 077 050 050 050 050 050 084 062 062 062 062 062 062 062 062 050 050 050 050 050 050 050 050 050 050 050 050 050 050 050 050 050 050 050 050 050 050 050 050 050 050 050 050 050 050 050 050 050 050 050 050 050 050 050 050 050 050 050 050 050 050 050 050 050 050
050 050 050 050 050 050 050 050 050 050 050 050 013 050 050 050 050 050 050 050 050 050 050 050 050 050 050 050 050 050 050 084 101 062 062 062 062 062 062 062 050 050 050 050 050 050 050 050 050 050 050 050 050 050 050 050 050 050 050 050 050 050 050 050 050 050 050 050 050 050 050 050 050 050 050 050 050 050 050 050 050 050 050 050 050 050 050 050 050 050
050 050 050 050 050 050 050 050 050 050 050 050 028 029 029 029 029 029 029 029 029 029 029 029 029 029 029 030 056 057 050 084 062 062 062 062 062 062 062 062 050 050 050 050 050 050 050 050 050 050 050 050 050 050 050 050 050 050 050 050 050 050 050 050 050 050 050 050 050 050 050 050 050 050 050 050 050 050 050 050 050 050 050 050 050 050 050 050 050 050
050 050 050 050 050 050 050 050 050 050 050 050 050 050 050 050 050 050 050 050 050 050 050 050 050 050 050 013 056 057 056 084 062 062 062 062 062 062 062 062 050 050 050 050 050 050 050 050 050 050 050 050 050 050 050 050 050 050 050 050 050 050 050 050 050 050 050 050 050 050 050 050 050 050 050 050 050 050 050 050 050 050 050 050 050 050 050 050 050 050
050 050 050 050 050 050 050 050 050 050 050 050 050 050 050 050 050 050 050 050 050 050 050 050 050 050 050 013 056 057 056 084 062 062 062 062 062 062 062 062 050 050 050 050 050 050 050 050 050 050 050 050 050 050 050 050 050 050 050 050 050 050 050 050 050 050 050 050 050 050 050 050 050 050 050 050 050 050 050 050 050 050 050 050 050 050 050 050 050 050
050 050 050 050 050 050 050 050 050 050 050 050 050 050 050 050 050 050 050 050 050 050 050 050 050 050 050 013 056 057 056 084 062 062 062 062 062 062 062 062 050 050 050 050 050 050 050 050 050 050 050 050 050 050 050 050 050 050 050 050 050 050 050 050 050 050 050 050 050 050 050 050 050 050 050 050 050 050 050 050 050 050 050 050 050 050 050 050 050 050
050 050 050 050 050 050 050 050 050 050 050 050 050 050 050 050 050 050 050 050 050 050 050 050 050 050 050 013 056 057 056 084 062 062 062 062 062 062 062 062 050 050 050 050 050 050 050 050 050 050 050 050 050 050 050 050 050 050 050 050 050 050 050 050 050 050 050 050 050 050 050 050 050 050 050 050 050 050 050 050 050 050 050 050 050 050 050 050 050 050
050 050 050 050 050 050 050 050 050 050 050 050 050 050 050 050 050 050 050 050 050 050 050 050 050 050 050 013 056 057 056 084 062 062 062 062 062 062 062 062 050 050 050 050 050 050 050 050 050 050 050 050 050 050 050 050 050 050 050 050 050 050 050 050 050 050 050 050 050 050 050 050 050 050 050 050 050 050 050 050 050 050 050 050 050 050 050 050 050 050